#.#############################
#.#.........#.#.......#.....#.#
#.###.#####.#.#.###.#######.#.#
#.........#...#...#...#.#...#.#
#.###########.###.#.###.#.###.#
#.......#.#...#...#...#.....#.#
#.#####.#.###.#####.###.###.#.#
#.....#.....#.#...#...#...#...#
#####.###########.#.###.###.#.#
#.........#.#.#.#.#.#.....#.#.#
###.#####.#.#.#.#.#.#####.###.#
#...#.....#.........#.#.#...#.#
###.#####.#.#########.#.#.#####
#.....#...#.....#...#.........#
###.#.#####.###.#.#.#.#####.#.#
#...#...#...#...#.#.....#.#.#.#
#####.###.###.#####.#####.###.#
#...#...#...#.........#.#...#.#
#.#####.###.#.#.#.#.###.#.#####
#.......#...#.#.#.#.....#.#...#
#.#####.#.#.#######.#.###.#.#.#
#...#.....#.#.......#.#.#...#.#
#.###########.#####.#.#.#.#####
#.#.............#...#.........#
#######.###.#.###.#####.#####.#
#...#.#.#.#.#.#.#.#...#.#.....#
#.###.#.#.#.###.#.#.#.#####.#.#
#.......#...#.#.....#.#.#...#.#
#.#####.#.###.#.#.#####.#.#.###
#.....#.#.#.....#.......#.#...#
#############################.#
